F 220, 100, 0
C 225, 30, 0

NO ./texture/img_no.xpm
SO ./texture/img_so.xpm
WE ./texture/img_we.xpm
EA ./texture/img_ea.xpm

1
1111111111
1000000001
111000000111111
110000010111111
100000000000001
1N00000000000011
111111111111111
